"","year","state","DEMOCRAT","REPUBLICAN","total"
"1",1976,"ALABAMA",659170,504070,1163240
"2",1980,"ALABAMA",636730,654192,1290922
"3",1984,"ALABAMA",551899,872849,1424748
"4",1988,"ALABAMA",549506,815576,1365082
"5",1992,"ALABAMA",690080,804283,1494363
"6",1996,"ALABAMA",662165,769044,1431209
"7",2000,"ALABAMA",692611,941173,1633784
"8",2004,"ALABAMA",693933,1176394,1870327
"9",2008,"ALABAMA",813479,1266546,2080025
"10",2012,"ALABAMA",795696,1255925,2051621
"11",2016,"ALABAMA",729547,1318255,2047802
"12",2020,"ALABAMA",849624,1441170,2290794
"13",1976,"ALASKA",44058,71555,115613
"14",1980,"ALASKA",41842,86112,127954
"15",1984,"ALASKA",62007,138377,200384
"16",1988,"ALASKA",72584,119251,191835
"17",1992,"ALASKA",78294,102000,180294
"18",1996,"ALASKA",80380,122746,203126
"19",2000,"ALASKA",79004,167398,246402
"20",2004,"ALASKA",111025,190889,301914
"21",2008,"ALASKA",123594,193841,317435
"22",2012,"ALASKA",122640,164676,287316
"23",2016,"ALASKA",116454,163387,279841
"24",2020,"ALASKA",153778,189951,343729
"25",1976,"ARIZONA",295602,418642,714244
"26",1980,"ARIZONA",246843,529688,776531
"27",1984,"ARIZONA",333854,681416,1015270
"28",1988,"ARIZONA",454029,702541,1156570
"29",1992,"ARIZONA",543050,572086,1115136
"30",1996,"ARIZONA",653288,622073,1275361
"31",2000,"ARIZONA",685341,781652,1466993
"32",2004,"ARIZONA",893524,1104294,1997818
"33",2008,"ARIZONA",1034707,1230111,2264818
"34",2012,"ARIZONA",1025232,1233654,2258886
"35",2016,"ARIZONA",1161209,1252401,2413610
"36",2020,"ARIZONA",1672143,1661686,3333829
"37",1976,"ARKANSAS",498604,267903,766507
"38",1980,"ARKANSAS",398041,403164,801205
"39",1984,"ARKANSAS",338646,534774,873420
"40",1988,"ARKANSAS",349237,466578,815815
"41",1992,"ARKANSAS",505823,337324,843147
"42",1996,"ARKANSAS",475171,325416,800587
"43",2000,"ARKANSAS",422768,472940,895708
"44",2004,"ARKANSAS",469953,572898,1042851
"45",2008,"ARKANSAS",422310,638017,1060327
"46",2012,"ARKANSAS",394409,647744,1042153
"47",2016,"ARKANSAS",380494,684872,1065366
"48",2020,"ARKANSAS",423932,760647,1184579
"49",1976,"CALIFORNIA",3742284,3882244,7624528
"50",1980,"CALIFORNIA",3082943,4522994,7605937
"51",1984,"CALIFORNIA",3922519,5467009,9389528
"52",1988,"CALIFORNIA",4702233,5054917,9757150
"53",1992,"CALIFORNIA",5121325,3630574,8751899
"54",1996,"CALIFORNIA",5119835,3828381,8948216
"55",2000,"CALIFORNIA",5861203,4567429,10428632
"56",2004,"CALIFORNIA",6745485,5509826,12255311
"57",2008,"CALIFORNIA",8274473,5011781,13286254
"58",2012,"CALIFORNIA",7854285,4839958,12694243
"59",2016,"CALIFORNIA",8753788,4483810,13237598
"60",2020,"CALIFORNIA",11110250,6006429,17116679
"61",1976,"COLORADO",460801,584278,1045079
"62",1980,"COLORADO",368009,652264,1020273
"63",1984,"COLORADO",454975,821817,1276792
"64",1988,"COLORADO",621453,728177,1349630
"65",1992,"COLORADO",629681,562850,1192531
"66",1996,"COLORADO",671152,691848,1363000
"67",2000,"COLORADO",738227,883748,1621975
"68",2004,"COLORADO",1001732,1101255,2102987
"69",2008,"COLORADO",1288576,1073589,2362165
"70",2012,"COLORADO",1323101,1185243,2508344
"71",2016,"COLORADO",1338870,1202484,2541354
"72",2020,"COLORADO",1804352,1364607,3168959
"73",1976,"CONNECTICUT",647895,719261,1367156
"74",1980,"CONNECTICUT",541732,677210,1218942
"75",1984,"CONNECTICUT",569597,890877,1460474
"76",1988,"CONNECTICUT",676584,750241,1426825
"77",1992,"CONNECTICUT",682318,578313,1260631
"78",1996,"CONNECTICUT",735740,483109,1218849
"79",2000,"CONNECTICUT",816015,561094,1377109
"80",2004,"CONNECTICUT",857488,693826,1551314
"81",2008,"CONNECTICUT",997772,629428,1627200
"82",2012,"CONNECTICUT",905083,634892,1539975
"83",2016,"CONNECTICUT",897572,673215,1570787
"84",2020,"CONNECTICUT",1080831,714717,1795548
"85",1976,"DELAWARE",122461,109780,232241
"86",1980,"DELAWARE",105754,111252,217006
"87",1984,"DELAWARE",101656,152190,253846
"88",1988,"DELAWARE",108647,139639,248286
"89",1992,"DELAWARE",126054,102313,228367
"90",1996,"DELAWARE",140355,99062,239417
"91",2000,"DELAWARE",180068,137288,317356
"92",2004,"DELAWARE",200152,171660,371812
"93",2008,"DELAWARE",255459,152374,407833
"94",2012,"DELAWARE",242584,165484,408068
"95",2016,"DELAWARE",235603,185127,420730
"96",2020,"DELAWARE",296268,200603,496871
"97",1976,"DISTRICT OF COLUMBIA",137818,27873,165691
"98",1980,"DISTRICT OF COLUMBIA",130231,23313,153544
"99",1984,"DISTRICT OF COLUMBIA",180408,29009,209417
"100",1988,"DISTRICT OF COLUMBIA",159407,27590,186997
"101",1992,"DISTRICT OF COLUMBIA",192619,20698,213317
"102",1996,"DISTRICT OF COLUMBIA",158220,17339,175559
"103",2000,"DISTRICT OF COLUMBIA",171923,18073,189996
"104",2004,"DISTRICT OF COLUMBIA",202970,21256,224226
"105",2008,"DISTRICT OF COLUMBIA",245800,17367,263167
"106",2012,"DISTRICT OF COLUMBIA",267070,21381,288451
"107",2016,"DISTRICT OF COLUMBIA",282830,12723,295553
"108",2020,"DISTRICT OF COLUMBIA",317323,18586,335909
"109",1976,"FLORIDA",1636000,1469531,3105531
"110",1980,"FLORIDA",1419475,2046951,3466426
"111",1984,"FLORIDA",1448816,2730350,4179166
"112",1988,"FLORIDA",1656701,2618885,4275586
"113",1992,"FLORIDA",2071698,2173310,4245008
"114",1996,"FLORIDA",2546870,2244536,4791406
"115",2000,"FLORIDA",2912253,2912790,5825043
"116",2004,"FLORIDA",3583544,3964522,7548066
"117",2008,"FLORIDA",4282074,4045624,8327698
"118",2012,"FLORIDA",4237756,4163447,8401203
"119",2016,"FLORIDA",4504975,4617886,9122861
"120",2020,"FLORIDA",5297045,5668731,10965776
"121",1976,"GEORGIA",979409,483743,1463152
"122",1980,"GEORGIA",890955,654168,1545123
"123",1984,"GEORGIA",706628,1068722,1775350
"124",1988,"GEORGIA",714792,1081331,1796123
"125",1992,"GEORGIA",1008966,995252,2004218
"126",1996,"GEORGIA",1053849,1080843,2134692
"127",2000,"GEORGIA",1116230,1419720,2535950
"128",2004,"GEORGIA",1366149,1914254,3280403
"129",2008,"GEORGIA",1844123,2048759,3892882
"130",2012,"GEORGIA",1773827,2078688,3852515
"131",2016,"GEORGIA",1877963,2089104,3967067
"132",2020,"GEORGIA",2473633,2461854,4935487
"133",1976,"HAWAII",147375,140003,287378
"134",1980,"HAWAII",135879,130112,265991
"135",1984,"HAWAII",147154,185050,332204
"136",1988,"HAWAII",192364,158625,350989
"137",1992,"HAWAII",179310,136822,316132
"138",1996,"HAWAII",205012,113943,318955
"139",2000,"HAWAII",205286,137845,343131
"140",2004,"HAWAII",231708,194191,425899
"141",2008,"HAWAII",325871,120566,446437
"142",2012,"HAWAII",306658,121015,427673
"143",2016,"HAWAII",266891,128847,395738
"144",2020,"HAWAII",366130,196864,562994
"145",1976,"IDAHO",126549,204151,330700
"146",1980,"IDAHO",110192,290699,400891
"147",1984,"IDAHO",108510,297523,406033
"148",1988,"IDAHO",147272,253881,401153
"149",1992,"IDAHO",137013,202645,339658
"150",1996,"IDAHO",165443,256595,422038
"151",2000,"IDAHO",138637,336937,475574
"152",2004,"IDAHO",181098,409235,590333
"153",2008,"IDAHO",236440,403012,639452
"154",2012,"IDAHO",212787,420911,633698
"155",2016,"IDAHO",189765,409055,598820
"156",2020,"IDAHO",287021,554119,841140
"157",1976,"ILLINOIS",2271295,2364269,4635564
"158",1980,"ILLINOIS",1981413,2358049,4339462
"159",1984,"ILLINOIS",2086499,2707103,4793602
"160",1988,"ILLINOIS",2215940,2310939,4526879
"161",1992,"ILLINOIS",2453350,1734096,4187446
"162",1996,"ILLINOIS",2341744,1587021,3928765
"163",2000,"ILLINOIS",2589026,2019421,4608447
"164",2004,"ILLINOIS",2891550,2345946,5237496
"165",2008,"ILLINOIS",3419348,2031179,5450527
"166",2012,"ILLINOIS",3019512,2135216,5154728
"167",2016,"ILLINOIS",3090729,2146015,5236744
"168",2020,"ILLINOIS",3471915,2446891,5918806
"169",1976,"INDIANA",1014714,1183958,2198672
"170",1980,"INDIANA",844197,1255656,2099853
"171",1984,"INDIANA",841481,1377230,2218711
"172",1988,"INDIANA",860643,1297763,2158406
"173",1992,"INDIANA",848420,989375,1837795
"174",1996,"INDIANA",887424,1006693,1894117
"175",2000,"INDIANA",901980,1245836,2147816
"176",2004,"INDIANA",969011,1479438,2448449
"177",2008,"INDIANA",1374039,1345648,2719687
"178",2012,"INDIANA",1152887,1420543,2573430
"179",2016,"INDIANA",1033126,1557286,2590412
"180",2020,"INDIANA",1242416,1729519,2971935
"181",1976,"IOWA",619931,632864,1252795
"182",1980,"IOWA",508672,676026,1184698
"183",1984,"IOWA",605620,703088,1308708
"184",1988,"IOWA",670557,545355,1215912
"185",1992,"IOWA",586353,504891,1091244
"186",1996,"IOWA",620258,492644,1112902
"187",2000,"IOWA",638517,634373,1272890
"188",2004,"IOWA",741898,751957,1493855
"189",2008,"IOWA",828940,682379,1511319
"190",2012,"IOWA",822544,730617,1553161
"191",2016,"IOWA",653669,800983,1454652
"192",2020,"IOWA",759061,897672,1656733
"193",1976,"KANSAS",430421,502752,933173
"194",1980,"KANSAS",326150,566812,892962
"195",1984,"KANSAS",333149,677296,1010445
"196",1988,"KANSAS",422636,554049,976685
"197",1992,"KANSAS",390434,449951,840385
"198",1996,"KANSAS",387659,583245,970904
"199",2000,"KANSAS",399276,622332,1021608
"200",2004,"KANSAS",434993,736456,1171449
"201",2008,"KANSAS",514765,699655,1214420
"202",2012,"KANSAS",440726,692634,1133360
"203",2016,"KANSAS",427005,671018,1098023
"204",2020,"KANSAS",570323,771406,1341729
"205",1976,"KENTUCKY",615717,531852,1147569
"206",1980,"KENTUCKY",617417,635274,1252691
"207",1984,"KENTUCKY",539539,821702,1361241
"208",1988,"KENTUCKY",580368,734281,1314649
"209",1992,"KENTUCKY",665104,617178,1282282
"210",1996,"KENTUCKY",636614,623283,1259897
"211",2000,"KENTUCKY",638923,872520,1511443
"212",2004,"KENTUCKY",712733,1069439,1782172
"213",2008,"KENTUCKY",751985,1048462,1800447
"214",2012,"KENTUCKY",679370,1087190,1766560
"215",2016,"KENTUCKY",628854,1202971,1831825
"216",2020,"KENTUCKY",772474,1326646,2099120
"217",1976,"LOUISIANA",661365,587446,1248811
"218",1980,"LOUISIANA",708453,792853,1501306
"219",1984,"LOUISIANA",651586,1037299,1688885
"220",1988,"LOUISIANA",717460,883702,1601162
"221",1992,"LOUISIANA",815971,733386,1549357
"222",1996,"LOUISIANA",927837,712586,1640423
"223",2000,"LOUISIANA",792344,927871,1720215
"224",2004,"LOUISIANA",820299,1102169,1922468
"225",2008,"LOUISIANA",782989,1148275,1931264
"226",2012,"LOUISIANA",809141,1152262,1961403
"227",2016,"LOUISIANA",780154,1178638,1958792
"228",2020,"LOUISIANA",856034,1255776,2111810
"229",1976,"MAINE",232279,236320,468599
"230",1980,"MAINE",220974,238522,459496
"231",1984,"MAINE",214515,336500,551015
"232",1988,"MAINE",243569,307131,550700
"233",1992,"MAINE",263420,206504,469924
"234",1996,"MAINE",312788,186378,499166
"235",2000,"MAINE",319951,286616,606567
"236",2004,"MAINE",396842,330201,727043
"237",2008,"MAINE",421923,295273,717196
"238",2012,"MAINE",401306,292276,693582
"239",2016,"MAINE",357735,335593,693328
"240",2020,"MAINE",435072,360737,795809
"241",1976,"MARYLAND",759612,672661,1432273
"242",1980,"MARYLAND",726161,680606,1406767
"243",1984,"MARYLAND",787935,879918,1667853
"244",1988,"MARYLAND",826304,876167,1702471
"245",1992,"MARYLAND",988571,707094,1695665
"246",1996,"MARYLAND",966207,681530,1647737
"247",2000,"MARYLAND",1144008,813827,1957835
"248",2004,"MARYLAND",1334500,1024703,2359203
"249",2008,"MARYLAND",1629467,959862,2589329
"250",2012,"MARYLAND",1677844,971869,2649713
"251",2016,"MARYLAND",1678006,943428,2621434
"252",2020,"MARYLAND",1985023,976414,2961437
"253",1976,"MASSACHUSETTS",1429475,1030276,2459751
"254",1980,"MASSACHUSETTS",1053802,1057631,2111433
"255",1984,"MASSACHUSETTS",1239606,1310936,2550542
"256",1988,"MASSACHUSETTS",1401415,1194635,2596050
"257",1992,"MASSACHUSETTS",1318639,805039,2123678
"258",1996,"MASSACHUSETTS",1571509,718058,2289567
"259",2000,"MASSACHUSETTS",1616487,878502,2494989
"260",2004,"MASSACHUSETTS",1803800,1071109,2874909
"261",2008,"MASSACHUSETTS",1904097,1108854,3012951
"262",2012,"MASSACHUSETTS",1921290,1188314,3109604
"263",2016,"MASSACHUSETTS",1995196,1090893,3086089
"264",2020,"MASSACHUSETTS",2382202,1167202,3549404
"265",1976,"MICHIGAN",1696714,1893742,3590456
"266",1980,"MICHIGAN",1661532,1915225,3576757
"267",1984,"MICHIGAN",1529638,2251571,3781209
"268",1988,"MICHIGAN",1675783,1965486,3641269
"269",1992,"MICHIGAN",1871182,1554940,3426122
"270",1996,"MICHIGAN",1989653,1481212,3470865
"271",2000,"MICHIGAN",2170418,1953139,4123557
"272",2004,"MICHIGAN",2479183,2313746,4792929
"273",2008,"MICHIGAN",2872579,2048639,4921218
"274",2012,"MICHIGAN",2564569,2115256,4679825
"275",2016,"MICHIGAN",2268839,2279543,4548382
"276",2020,"MICHIGAN",2804040,2649852,5453892
"277",1976,"MINNESOTA",1070440,819395,1889835
"278",1980,"MINNESOTA",954173,873268,1827441
"279",1984,"MINNESOTA",1036364,1032603,2068967
"280",1988,"MINNESOTA",1109471,962337,2071808
"281",1992,"MINNESOTA",1020997,747841,1768838
"282",1996,"MINNESOTA",1120380,766395,1886775
"283",2000,"MINNESOTA",1168266,1109659,2277925
"284",2004,"MINNESOTA",1445014,1346695,2791709
"285",2008,"MINNESOTA",1573354,1275409,2848763
"286",2012,"MINNESOTA",1546167,1320225,2866392
"287",2016,"MINNESOTA",1367705,1322949,2690654
"288",2020,"MINNESOTA",1717077,1484065,3201142
"289",1976,"MISSISSIPPI",381329,366846,748175
"290",1980,"MISSISSIPPI",429281,441089,870370
"291",1984,"MISSISSIPPI",352192,582377,934569
"292",1988,"MISSISSIPPI",363921,557890,921811
"293",1992,"MISSISSIPPI",400258,487793,888051
"294",1996,"MISSISSIPPI",394022,439838,833860
"295",2000,"MISSISSIPPI",404614,572844,977458
"296",2004,"MISSISSIPPI",457766,672660,1130426
"297",2008,"MISSISSIPPI",554662,724597,1279259
"298",2012,"MISSISSIPPI",562949,710746,1273695
"299",2016,"MISSISSIPPI",485131,700714,1185845
"300",2020,"MISSISSIPPI",539398,756764,1296162
"301",1976,"MISSOURI",998387,927443,1925830
"302",1980,"MISSOURI",931182,1074181,2005363
"303",1984,"MISSOURI",848583,1274188,2122771
"304",1988,"MISSOURI",1001619,1084953,2086572
"305",1992,"MISSOURI",1053873,811159,1865032
"306",1996,"MISSOURI",1025935,890016,1915951
"307",2000,"MISSOURI",1111138,1189924,2301062
"308",2004,"MISSOURI",1259171,1455713,2714884
"309",2008,"MISSOURI",1441911,1445814,2887725
"310",2012,"MISSOURI",1223796,1482440,2706236
"311",2016,"MISSOURI",1071068,1594511,2665579
"312",2020,"MISSOURI",1253014,1718736,2971750
"313",1976,"MONTANA",149259,173703,322962
"314",1980,"MONTANA",118032,206814,324846
"315",1984,"MONTANA",146742,232450,379192
"316",1988,"MONTANA",168936,190412,359348
"317",1992,"MONTANA",154507,144207,298714
"318",1996,"MONTANA",167922,179652,347574
"319",2000,"MONTANA",137126,240178,377304
"320",2004,"MONTANA",173710,266063,439773
"321",2008,"MONTANA",231667,242763,474430
"322",2012,"MONTANA",201839,267928,469767
"323",2016,"MONTANA",177709,279240,456949
"324",2020,"MONTANA",244786,343602,588388
"325",1976,"NEBRASKA",233293,359219,592512
"326",1980,"NEBRASKA",166424,419214,585638
"327",1984,"NEBRASKA",187866,460054,647920
"328",1988,"NEBRASKA",259235,397956,657191
"329",1992,"NEBRASKA",216864,343678,560542
"330",1996,"NEBRASKA",236761,363467,600228
"331",2000,"NEBRASKA",231780,433862,665642
"332",2004,"NEBRASKA",254328,512814,767142
"333",2008,"NEBRASKA",333319,452979,786298
"334",2012,"NEBRASKA",302081,475064,777145
"335",2016,"NEBRASKA",284494,495961,780455
"336",2020,"NEBRASKA",374583,556846,931429
"337",1976,"NEVADA",92479,101273,193752
"338",1980,"NEVADA",66666,155017,221683
"339",1984,"NEVADA",91655,188770,280425
"340",1988,"NEVADA",132738,206040,338778
"341",1992,"NEVADA",189148,175828,364976
"342",1996,"NEVADA",203974,199244,403218
"343",2000,"NEVADA",279978,301575,581553
"344",2004,"NEVADA",397190,418690,815880
"345",2008,"NEVADA",533736,412827,946563
"346",2012,"NEVADA",531373,463567,994940
"347",2016,"NEVADA",539260,512058,1051318
"348",2020,"NEVADA",703486,669890,1373376
"349",1976,"NEW HAMPSHIRE",147645,185935,333580
"350",1980,"NEW HAMPSHIRE",108864,221705,330569
"351",1984,"NEW HAMPSHIRE",120347,267050,387397
"352",1988,"NEW HAMPSHIRE",163696,281537,445233
"353",1992,"NEW HAMPSHIRE",209040,202484,411524
"354",1996,"NEW HAMPSHIRE",246166,196486,442652
"355",2000,"NEW HAMPSHIRE",266348,273559,539907
"356",2004,"NEW HAMPSHIRE",340511,331237,671748
"357",2008,"NEW HAMPSHIRE",384826,316534,701360
"358",2012,"NEW HAMPSHIRE",369561,329918,699479
"359",2016,"NEW HAMPSHIRE",348526,345790,694316
"360",2020,"NEW HAMPSHIRE",424921,365654,790575
"361",1976,"NEW JERSEY",1444653,1509688,2954341
"362",1980,"NEW JERSEY",1147364,1546557,2693921
"363",1984,"NEW JERSEY",1261323,1933630,3194953
"364",1988,"NEW JERSEY",1320352,1743192,3063544
"365",1992,"NEW JERSEY",1436206,1356865,2793071
"366",1996,"NEW JERSEY",1652361,1103099,2755460
"367",2000,"NEW JERSEY",1788850,1284173,3073023
"368",2004,"NEW JERSEY",1911430,1670003,3581433
"369",2008,"NEW JERSEY",2215422,1613207,3828629
"370",2012,"NEW JERSEY",2122786,1478088,3600874
"371",2016,"NEW JERSEY",2148278,1601933,3750211
"372",2020,"NEW JERSEY",2608335,1883274,4491609
"373",1976,"NEW MEXICO",201148,211419,412567
"374",1980,"NEW MEXICO",167826,250779,418605
"375",1984,"NEW MEXICO",201769,307101,508870
"376",1988,"NEW MEXICO",244497,270341,514838
"377",1992,"NEW MEXICO",261617,212824,474441
"378",1996,"NEW MEXICO",273495,232751,506246
"379",2000,"NEW MEXICO",286783,286417,573200
"380",2004,"NEW MEXICO",370942,376930,747872
"381",2008,"NEW MEXICO",472422,346832,819254
"382",2012,"NEW MEXICO",415335,335788,751123
"383",2016,"NEW MEXICO",385234,319667,704901
"384",2020,"NEW MEXICO",501614,401894,903508
"385",1976,"NEW YORK",3244165,2825913,6070078
"386",1980,"NEW YORK",2728372,2637700,5366072
"387",1984,"NEW YORK",3001285,3376519,6377804
"388",1988,"NEW YORK",3255487,2838414,6093901
"389",1992,"NEW YORK",3346894,2041690,5388584
"390",1996,"NEW YORK",3649630,1738707,5388337
"391",2000,"NEW YORK",3942215,2258577,6200792
"392",2004,"NEW YORK",4180755,2806993,6987748
"393",2008,"NEW YORK",4645332,2418323,7063655
"394",2012,"NEW YORK",4324228,2223397,6547625
"395",2016,"NEW YORK",4379789,2527142,6906931
"396",2020,"NEW YORK",5230985,3244798,8475783
"397",1976,"NORTH CAROLINA",927365,741960,1669325
"398",1980,"NORTH CAROLINA",875635,915018,1790653
"399",1984,"NORTH CAROLINA",824287,1346481,2170768
"400",1988,"NORTH CAROLINA",890167,1237258,2127425
"401",1992,"NORTH CAROLINA",1114042,1134661,2248703
"402",1996,"NORTH CAROLINA",1107849,1225938,2333787
"403",2000,"NORTH CAROLINA",1257692,1631163,2888855
"404",2004,"NORTH CAROLINA",1525849,1961166,3487015
"405",2008,"NORTH CAROLINA",2142651,2128474,4271125
"406",2012,"NORTH CAROLINA",2178391,2270395,4448786
"407",2016,"NORTH CAROLINA",2189316,2362631,4551947
"408",2020,"NORTH CAROLINA",2684292,2758773,5443065
"409",1976,"NORTH DAKOTA",136078,153684,289762
"410",1980,"NORTH DAKOTA",79189,193695,272884
"411",1984,"NORTH DAKOTA",104429,200336,304765
"412",1988,"NORTH DAKOTA",127739,166559,294298
"413",1992,"NORTH DAKOTA",99168,136244,235412
"414",1996,"NORTH DAKOTA",106905,125050,231955
"415",2000,"NORTH DAKOTA",95284,174852,270136
"416",2004,"NORTH DAKOTA",111052,196651,307703
"417",2008,"NORTH DAKOTA",141278,168601,309879
"418",2012,"NORTH DAKOTA",124966,188320,313286
"419",2016,"NORTH DAKOTA",93758,216794,310552
"420",2020,"NORTH DAKOTA",114902,235595,350497
"421",1976,"OHIO",2009959,2000626,4010585
"422",1980,"OHIO",1752414,2206545,3958959
"423",1984,"OHIO",1825440,2678559,4503999
"424",1988,"OHIO",1939629,2416549,4356178
"425",1992,"OHIO",1984942,1894310,3879252
"426",1996,"OHIO",2148222,1859883,4008105
"427",2000,"OHIO",2183628,2350363,4533991
"428",2004,"OHIO",2741165,2859764,5600929
"429",2008,"OHIO",2940044,2677820,5617864
"430",2012,"OHIO",2827621,2661407,5489028
"431",2016,"OHIO",2394164,2841005,5235169
"432",2020,"OHIO",2679165,3154834,5833999
"433",1976,"OKLAHOMA",532442,545708,1078150
"434",1980,"OKLAHOMA",402026,695570,1097596
"435",1984,"OKLAHOMA",385080,861530,1246610
"436",1988,"OKLAHOMA",483423,678367,1161790
"437",1992,"OKLAHOMA",473066,592929,1065995
"438",1996,"OKLAHOMA",488105,582315,1070420
"439",2000,"OKLAHOMA",474276,744337,1218613
"440",2004,"OKLAHOMA",503966,959792,1463758
"441",2008,"OKLAHOMA",502496,960165,1462661
"442",2012,"OKLAHOMA",443547,891325,1334872
"443",2016,"OKLAHOMA",420375,949136,1369511
"444",2020,"OKLAHOMA",503890,1020280,1524170
"445",1976,"OREGON",490407,492120,982527
"446",1980,"OREGON",456890,571044,1027934
"447",1984,"OREGON",536479,685700,1222179
"448",1988,"OREGON",616206,560126,1176332
"449",1992,"OREGON",621314,475757,1097071
"450",1996,"OREGON",649641,538152,1187793
"451",2000,"OREGON",720342,713577,1433919
"452",2004,"OREGON",943163,866831,1809994
"453",2008,"OREGON",1037291,738475,1775766
"454",2012,"OREGON",970488,754175,1724663
"455",2016,"OREGON",1002106,782403,1784509
"456",2020,"OREGON",1340383,958448,2298831
"457",1976,"PENNSYLVANIA",2328677,2205604,4534281
"458",1980,"PENNSYLVANIA",1937540,2261872,4199412
"459",1984,"PENNSYLVANIA",2228131,2584323,4812454
"460",1988,"PENNSYLVANIA",2194944,2300087,4495031
"461",1992,"PENNSYLVANIA",2239164,1791841,4031005
"462",1996,"PENNSYLVANIA",2215819,1801169,4016988
"463",2000,"PENNSYLVANIA",2485967,2281127,4767094
"464",2004,"PENNSYLVANIA",2938095,2793847,5731942
"465",2008,"PENNSYLVANIA",3276363,2655885,5932248
"466",2012,"PENNSYLVANIA",2990274,2680434,5670708
"467",2016,"PENNSYLVANIA",2926441,2970733,5897174
"468",2020,"PENNSYLVANIA",3458229,3377674,6835903
"469",1976,"RHODE ISLAND",227636,181249,408885
"470",1980,"RHODE ISLAND",198342,154793,353135
"471",1984,"RHODE ISLAND",197106,212080,409186
"472",1988,"RHODE ISLAND",225123,177761,402884
"473",1992,"RHODE ISLAND",213299,131601,344900
"474",1996,"RHODE ISLAND",233050,104683,337733
"475",2000,"RHODE ISLAND",249508,130555,380063
"476",2004,"RHODE ISLAND",259760,169046,428806
"477",2008,"RHODE ISLAND",296571,165391,461962
"478",2012,"RHODE ISLAND",279677,157204,436881
"479",2016,"RHODE ISLAND",252525,180543,433068
"480",2020,"RHODE ISLAND",307486,199922,507408
"481",1976,"SOUTH CAROLINA",450807,346149,796956
"482",1980,"SOUTH CAROLINA",428220,439277,867497
"483",1984,"SOUTH CAROLINA",344459,615539,959998
"484",1988,"SOUTH CAROLINA",370554,606443,976997
"485",1992,"SOUTH CAROLINA",525514,577507,1103021
"486",1996,"SOUTH CAROLINA",506152,573339,1079491
"487",2000,"SOUTH CAROLINA",566037,786892,1352929
"488",2004,"SOUTH CAROLINA",661669,937974,1599643
"489",2008,"SOUTH CAROLINA",862449,1034896,1897345
"490",2012,"SOUTH CAROLINA",865941,1071645,1937586
"491",2016,"SOUTH CAROLINA",855373,1155389,2010762
"492",2020,"SOUTH CAROLINA",1091541,1385103,2476644
"493",1976,"SOUTH DAKOTA",147068,151505,298573
"494",1980,"SOUTH DAKOTA",103855,198343,302198
"495",1984,"SOUTH DAKOTA",116113,200267,316380
"496",1988,"SOUTH DAKOTA",145560,165415,310975
"497",1992,"SOUTH DAKOTA",124888,136718,261606
"498",1996,"SOUTH DAKOTA",139333,150543,289876
"499",2000,"SOUTH DAKOTA",118804,190700,309504
"500",2004,"SOUTH DAKOTA",149244,232584,381828
"501",2008,"SOUTH DAKOTA",170924,203054,373978
"502",2012,"SOUTH DAKOTA",145039,210610,355649
"503",2016,"SOUTH DAKOTA",117458,227721,345179
"504",2020,"SOUTH DAKOTA",150471,261043,411514
"505",1976,"TENNESSEE",825879,633969,1459848
"506",1980,"TENNESSEE",783051,787761,1570812
"507",1984,"TENNESSEE",711714,990212,1701926
"508",1988,"TENNESSEE",679794,947233,1627027
"509",1992,"TENNESSEE",933521,841300,1774821
"510",1996,"TENNESSEE",909146,863530,1772676
"511",2000,"TENNESSEE",981720,1061949,2043669
"512",2004,"TENNESSEE",1036477,1384375,2420852
"513",2008,"TENNESSEE",1087437,1479178,2566615
"514",2012,"TENNESSEE",960709,1462330,2423039
"515",2016,"TENNESSEE",870695,1522925,2393620
"516",2020,"TENNESSEE",1143711,1852475,2996186
"517",1976,"TEXAS",2082319,1953300,4035619
"518",1980,"TEXAS",1881147,2510705,4391852
"519",1984,"TEXAS",1949276,3433428,5382704
"520",1988,"TEXAS",2352748,3036829,5389577
"521",1992,"TEXAS",2281815,2496071,4777886
"522",1996,"TEXAS",2459683,2736167,5195850
"523",2000,"TEXAS",2433746,3799639,6233385
"524",2004,"TEXAS",2832704,4526917,7359621
"525",2008,"TEXAS",3528633,4479328,8007961
"526",2012,"TEXAS",3308124,4569843,7877967
"527",2016,"TEXAS",3877868,4685047,8562915
"528",2020,"TEXAS",5259126,5890347,11149473
"529",1976,"UTAH",182110,337908,520018
"530",1980,"UTAH",124266,439687,563953
"531",1984,"UTAH",155369,469105,624474
"532",1988,"UTAH",207343,428442,635785
"533",1992,"UTAH",183429,322632,506061
"534",1996,"UTAH",221633,361911,583544
"535",2000,"UTAH",203053,515096,718149
"536",2004,"UTAH",241199,663742,904941
"537",2008,"UTAH",327670,596030,923700
"538",2012,"UTAH",251813,740600,992413
"539",2016,"UTAH",310674,515211,825885
"540",2020,"UTAH",560282,865140,1425422
"541",1976,"VERMONT",77798,100387,178185
"542",1980,"VERMONT",81952,94628,176580
"543",1984,"VERMONT",95730,135865,231595
"544",1988,"VERMONT",115775,124331,240106
"545",1992,"VERMONT",133592,88122,221714
"546",1996,"VERMONT",137894,80352,218246
"547",2000,"VERMONT",149022,119775,268797
"548",2004,"VERMONT",184067,121180,305247
"549",2008,"VERMONT",219262,98974,318236
"550",2012,"VERMONT",199239,92698,291937
"551",2016,"VERMONT",178573,95369,273942
"552",2020,"VERMONT",242820,112704,355524
"553",1976,"VIRGINIA",813896,836554,1650450
"554",1980,"VIRGINIA",752174,989609,1741783
"555",1984,"VIRGINIA",796250,1337078,2133328
"556",1988,"VIRGINIA",859799,1309162,2168961
"557",1992,"VIRGINIA",1038650,1150517,2189167
"558",1996,"VIRGINIA",1091060,1138350,2229410
"559",2000,"VIRGINIA",1217290,1437490,2654780
"560",2004,"VIRGINIA",1454742,1716959,3171701
"561",2008,"VIRGINIA",1959532,1725005,3684537
"562",2012,"VIRGINIA",1971820,1822522,3794342
"563",2016,"VIRGINIA",1981473,1769443,3750916
"564",2020,"VIRGINIA",2413568,1962430,4375998
"565",1976,"WASHINGTON",717323,777732,1495055
"566",1980,"WASHINGTON",650193,865244,1515437
"567",1984,"WASHINGTON",798352,1051670,1850022
"568",1988,"WASHINGTON",933516,903835,1837351
"569",1992,"WASHINGTON",993037,731234,1724271
"570",1996,"WASHINGTON",1123323,840712,1964035
"571",2000,"WASHINGTON",1247652,1108864,2356516
"572",2004,"WASHINGTON",1510201,1304894,2815095
"573",2008,"WASHINGTON",1750848,1229216,2980064
"574",2012,"WASHINGTON",1755396,1290670,3046066
"575",2016,"WASHINGTON",1742718,1221747,2964465
"576",2020,"WASHINGTON",2369612,1584651,3954263
"577",1976,"WEST VIRGINIA",435864,314726,750590
"578",1980,"WEST VIRGINIA",367462,334206,701668
"579",1984,"WEST VIRGINIA",328125,405483,733608
"580",1988,"WEST VIRGINIA",341016,310065,651081
"581",1992,"WEST VIRGINIA",331001,241974,572975
"582",1996,"WEST VIRGINIA",327812,233946,561758
"583",2000,"WEST VIRGINIA",295497,336475,631972
"584",2004,"WEST VIRGINIA",326541,423778,750319
"585",2008,"WEST VIRGINIA",303857,397466,701323
"586",2012,"WEST VIRGINIA",238269,417655,655924
"587",2016,"WEST VIRGINIA",188794,489371,678165
"588",2020,"WEST VIRGINIA",235984,545382,781366
"589",1976,"WISCONSIN",1040232,1004987,2045219
"590",1980,"WISCONSIN",981584,1088845,2070429
"591",1984,"WISCONSIN",995740,1198584,2194324
"592",1988,"WISCONSIN",1126794,1047499,2174293
"593",1992,"WISCONSIN",1041066,930855,1971921
"594",1996,"WISCONSIN",1071971,845029,1917000
"595",2000,"WISCONSIN",1242987,1237279,2480266
"596",2004,"WISCONSIN",1489504,1478120,2967624
"597",2008,"WISCONSIN",1677211,1262393,2939604
"598",2012,"WISCONSIN",1620985,1410966,3031951
"599",2016,"WISCONSIN",1382536,1405284,2787820
"600",2020,"WISCONSIN",1630866,1610184,3241050
"601",1976,"WYOMING",62239,92717,154956
"602",1980,"WYOMING",49427,110700,160127
"603",1984,"WYOMING",53370,133241,186611
"604",1988,"WYOMING",67113,106867,173980
"605",1992,"WYOMING",68160,79347,147507
"606",1996,"WYOMING",77934,105388,183322
"607",2000,"WYOMING",60481,147947,208428
"608",2004,"WYOMING",70776,167629,238405
"609",2008,"WYOMING",82868,164958,247826
"610",2012,"WYOMING",69286,170962,240248
"611",2016,"WYOMING",55973,174419,230392
"612",2020,"WYOMING",73491,193559,267050
